  +--------------------------+                
  |..........................|  +-----+       
  |..........................|  |.....|       
  |..........................|  +---#-+       
  |..........................|      #         
  |..........................|      #         
  |..........................#############    
  |..........................|           #    
  +--------------------------+           #    
                                         #    
                               +---------#---+
                               |.............|
                               |.............|
                               |.............|
                               +-------------+